....#.........#....#
.#...#.....#..#.....
......#..#..#.#.....
...#..##....#...#.#.
.#.....#...#........
#............#..#.##
..#..#..............
#..#.#......#.......
.....#.#............
.#.#...#........#..#
.#........#....#....
#.....#...#...#.#...
..#.#..##.....#.#.#.
##..................
.#...#...#..........
...#.#.#..#..#.#...#
........#..#.##.....
.##.#........#.#....
...#.....#...#......
##.....#...........#
\robot 8 17
