..##.#..##...#...#..
.....#..#..###..#...
..#..#..#...##..#.#.
.##..#..#....#......
........#...........
.....#..#.#.......##
#....#..#..........#
...#.#.##.....#.##..
#...##..#...#...#...
..#.##..#.....#.#...
..#..#..##.#........
#.#.###.#....#.#.#..
#....##.#.#.#..#..#.
.#..###.#.........#.
.#..###.#.....#.#...
..#..#..........##.#
#.#..#..#...........
.#..##..#....#......
...#.#..##..........
.....#..#....#......
\robot 0 0
\robot 19 0
\robot 10 6
